1111111111111
1P0100C000001
1000011111001
1000110000001
1111111111111
