1111111111111
1P0100000C001
1000011111001
100011E00P001
1111111111111
