1111111111111111
10010000000C111
10000111110011
1P0011E000001
111111111111111111
