11111111111111111111
1P000000000000000001
10000000000000000001
10000000X00000000001
10000000000000000001
10000000000000000001
10000000000000000001
10000000000000000001
10000000000000000001
10000000000000000001
10000000000000000001
10000000000000000001
10000000000000000001
10000000X00000000001
10000000000000000001
10000000000000000001
10000000000000000001
10000000000000000001
10X00000000000000CE1
11111111111111111111
